....................
....................
....................
....................
....................
....................
....................
....................
........CCCCCCCCCCCC
........CCCCCCCCCCCC
........CCCCCCCCCCCC
........CCCCCCCCCCCC
........CCCC........
........CCCC........
........CCCC........
........CCCC........
........CCCC........
........CCCC........
........CCCC........
........CCCC........