....................
....................
....................
....................
....................
....................
....................
....................
CCCCCCCCCCCCCCCCCCCC
CCCCCCCCCCCCCCCCCCCC
CCCCCCCCCCCCCCCCCCCC
CCCCCCCCCCCCCCCCCCCC
........CCCC........
........CCCC........
........CCCC........
........CCCC........
........CCCC........
........CCCC........
........CCCC........
........CCCC........