........CCCC........
........CCCC........
........CCCC........
........CCCC........
........CCCC........
........CCCC........
........CCCC........
........CCCC........
CCCCCCCCCCCCCCCCCCCC
CCCCCCCCCCCCCCCCCCCC
CCCCCCCCCCCCCCCCCCCC
CCCCCCCCCCCCCCCCCCCC
....................
....................
....................
....................
....................
....................
....................
....................