........CCCC........
........CCCC........
........CCCC........
........CCCC........
........CCCC........
........CCCC........
........CCCC........
........CCCC........
CCCCCCCCCCCC........
CCCCCCCCCCCC........
CCCCCCCCCCCC........
CCCCCCCCCCCC........
....................
....................
....................
....................
....................
....................
....................
....................